
NO ./textures/eagle.xpm
SO ./textures/greystone.xpm




WE ./textures/purplestone.xpm





EA ./textures/red.xpm

F 220,100,0




C 225,30,0

111111111111
100000000001
101100110001
1001000000N1
111111111111
