NO scenes/assets/2_north_texture_basic.xpm
WE scenes/assets/2_west_texture_basic.xpm
SO scenes/assets/2_south_texture_basic.xpm
EA scenes/assets/2_east_texture_basic.xpm



C 0,0,0
F 128,128,128

111111111111111111111111111111
100000000000000000000000000001
111110000000000000000011111111
100000000000000000000000000001
100000111110000000000000000001
100000111110000000000000000001
100000111110000000000000000001
100000000000000000000000000001
100000000000000000000000000001
100000000000000000111111111111
100000000000000000111111111111
100000000000000000111111111111
100000000000000000000000000001
111111100000000000000000000001
10000000000N000000111100000001
100000000000000000000100000001
111111111111111111111111111111
