NO scenes/assets/bush2.xpm
WE scenes/assets/bush2.xpm
SO scenes/assets/bush2.xpm
EA scenes/assets/bush2.xpm


C 0,0,0
F 34,139,34

11111111111111111111111111111111111111
10000000001000000000000000100000000001
10111111101011111111111110101111111101
10100000101010000000000010101000000101
10101110101010111111111010101011110101
10101000101010100000001010101010010101
10101011101010101111101010101010110101
10101010001010101000101010101010100101
10101011111010101010101010101010111101
10101000000010101010101010101010000001
10101111111110101010101010101011111101
10100000000000101010101010101000000101
10111111111111101010101010101111111101
10000000000000001010101010100000000001
11111111111111101010101010111111111111
10000000000000101010101010000000000001
10111111111111101010101011111111111101
10100000000000101010101000000000000101
10101111111110101010101111111111110101
10101000000010101010100000000000010101
10101011111110101010111111111111010101
10101010000000101010000000000001010101
10101010111111101011111111111101010101
10101010100000001010000000000101010101
10101010101111111010111111110101010101
10101010101000000010100000010101010101
10101010101011111110101111010101010101
10101010101010000000101000010101010101
10101010101010111111101011110101010101
10101010101010100000001010000101010101
10101010101010101111111010111101010101
1010101010101010100000N010000001010101
10101010101010101111111011111111010101
10101010101010100000000000000000010101
10101010101010111111111111111111110101
10101010101010000000000000000000000101
10101010101011111111111111111111111101
10101010101000000000000000000000000001
10101010101111111111111111111111111111
10101010100000000000000000000000000001
10101010111111111111111111111111111101
10101010000000000000000000000000000101
10101011111111111111111111111111110101
10101000000000000000000000000000010101
10101111111111111111111111111111010101
10100000000000000000000000000000010101
10111111111111111111111111111111110101
10000000000000000000000000000000000001
11111111111111111111111111111111111111
