NO scenes/assets/wall_texture_brown_torch_1.xpm
WE scenes/assets/wall_texture_brown_torch_1.xpm
SO scenes/assets/wall_texture_brown_torch_1.xpm
EA scenes/assets/wall_texture_brown_torch_1.xpm

C 0,0,0
F 28,15,8

        1111111111111111111111111
        1000000000110000000000001
        101100000111000000S000001
        1001000000000000000000001
111111111011000001110000000000001
100000000011000001110110110111111
11110111111111011100000010001
11110111 11111011101010010001
11000001110101010000000010001
10000000001000000100000000001
10000000000000001101010010001
1100000111010101111101111000111
11110111 1110101 101100000001
11111111 1111111 111111110111
                     10110111
                     10000001
                      110011
                       1111
