NO textures/north.xpm
SO       ./textures/south.xpm
F       12,   12,   56
EA      ./textures/east.xpm
C 56, 59, 12
WE      ./textures/west.xpm

1111111111111
