NO textures/nor.xpm                              
WE                aa.xpm
SO     ./textures/south.xpm
EA      ./textures/east.xpm


C 125,12,14
F 14,14,14

111111111111111111111111111111     
111111110N0001111111
       1111111                             
1111111111111111
1111111111111111111111111111111            
                        