NO textures/nor.xpm
WE      textures/north.xpm
SO       ./textures/south.xpm
EA      ./textures/east.xpm


C 125,12,14
F 14,14,14

11111111
10001001
10000111
10000001
11111111
