

F 14,14,14


NO textures/north.xpm


SO       ./textures/south.xpm
EA      ./textures/east.xpm


C 125,12,14

WE      ./textures/north.xpm



11111111
100000W1
10000001
11111111
