NO assets/1_north_texture_basic.xpm
WE assets/1_west_texture_basic.xpm
SO assets/1_south_texture_basic.xpm
EA assets/1_east_texture_basic.xpm


C 		54, 12,          124
F 1,32,98

11111111111111111111111
10000000000000001000001
10111111111111101110101
10100000000000100010101
10111111111111101110101
10000000000000001000001
11111000111111111111111
10001000100000000000001
10001000101111111111101
1000100010100000000101
10001000101011111110101
10001000001010000010101
10001111111010111110101
10000000000010000000101
11111111111111111111111
10000000000000000000001
10000000000N00000000001
10000000000000000000001
11111111111111111111111
