




NO textures/north.xpm
WE      ./textures/north.xpm
SO       ./textures/south.xpm
EA      ./textures/east.xpm


C 125,12,12
F 14,14,14

11111111
100000W1
10000001
11111111
