NO  aa.xpm
WE 			aa.xpm
SO ./textures/south.xpm
EA            /textures/east.xpm


C 		54, 12,          124
F 1,32,98

1111111111111111111111111111111111
111111110N00011111111111111111111
       111100000000000000111100001
111111111111111000000000000111111
111111111111111111111111111
