NO textures/nor.xpm
WE        textures/north.xpm
SO       ./textures/south.xpm
EA      ./textures/east.xpm


C 125,12,14
F 14,14,14

111111111111111111111111111111
111111110000011111111

111111100000010000111
      11000000N0000010
1111111111111111111111111111111
