11111111
111111111
000


NO textures/north.xpm
SO       ./textures/west.xpm
EA      ./textures/east.xpm

WE      ./textures/west.xpm

