NO assets/1_north_texture_basic.xpm
WE assets/1_west_texture_basic.xpm
SO assets/1_south_texture_basic.xpm
EA assets/1_east_texture_basic.xpm


C 		54, 12,          124
F 1,32,98

111111111111111111111111111111
100000000000000000000000000001
100000000000000000000000000001
100000000000000000000000000001
100000111110000000000000000001
100000100010000000000000000001
100000111110000000000000000001
100000000000000000000000000001
100000000000000000000000000001
100000000000000000111111111111
100000000000000000100000000001
100000000000000000111111111111
100000000000000000000000000001
100000000000000000000000000001
10000000000N000000000000000001
100000000000000000000000000001
111111111111111111111111111111
