F 14,14,14




SO       ./textures/south.xpm
EA      ./textures/east.xpm

C 12,12,14

WE      ./textures/west.xpm

NO textures/north.xpm



11111111
100000W1
10000001
11111111
