F 14,14,14

C 12,12,12



SO       ./textures/south.xpm
EA      ./textures/east.xpm


WE      ./textures/west.xpm

NO textures/north.xpm





11111111
100000W1
10000001
11111111
