NO ./textures/eagle.xpm
SO ./textures/greystone.xpm
WE ./textures/purplestone.xpm
EA ./textures/red.xpm
F 225,30,0
C 0, 20, 220

111111111
1000N0011
101100101
100100001
111111111
