NO ./textures/eagle.xpm
SO ./textures/greystone.xpm
WE ./textures/purplestone.xpm
EA ./textures/red.xpm

F 220,100,0
C 225,30,0

      111111111111
100000000001
  
1011001    1000111
10010000 00N1
111111111111


