NO ./worlds/assets/bookshelf.xpm
WE ./worlds/assets/bookshelf.xpm
SO ./worlds/assets/bookshelf.xpm
EA ./worlds/assets/bookshelf.xpm


C 169,79,39
F 240, 190, 80

111111111111111111111111111111
100000000000000000010000000001
100000000000000000010000000001
100000000000000000010000000001
100000111110000000000000000001
100000100010000000111111111111
100000111110000000000000000001
100000000000000000000000000001
111000000000000000000000000001
100000000000000000111111111111
100000011100000000000000000001
100000000000000000111111111111
100000000000000000000000000001
101011111100000000000000000001
10000000000N000000100000000001
100000000000000000100000000001
111111111111111111111111111111
