NO ./worlds/assets/tree2.xpm
WE ./worlds/assets/tree2.xpm
SO ./worlds/assets/tree2.xpm
EA ./worlds/assets/tree2.xpm

C 7,7,7
F 34,139,34

111111111111111111111111111111
100000000111000010000000001111
100000000000000000010000000001
100000000000000000010000000001
100000111110001000000000000001
100000100010000000111111111111
100000111110000000000000000001
100000000000000001100001110001
111000001110000000000000000001
100000000000000000111111111111
100000011100000000000000000001
100011100000001100111111111111
100000000000000000000000000001
101011111100000110000001000001
10000000000N000000100000000001
100000001111000000100000000001
111111111111111111111111111111
