NO ./textures/eagle.xpm
SO ./textures/greystone.xpm
WE ./textures/purplestone.xpm
EA ./textures/red.xpm


F 220,100,0
F 220,100,0
C 225,30,0

1111
1001
1111
