NO ./textures/eagle.xpm
SO ./textures/greystone.xpm
WE ./textures/purplestone.xpm
EA ./textures/red.xpm

F 220,100,0
C 225,30,0

111111111111
100000010001
101100000111
100100000001
111111111110 